from,to,"ver[el[, 1], ]","ver2[el[, 2], ]"
1,5,Es,ky
1,2,Es,V9
3,4,xX,JW
4,5,JW,ky
5,6,ky,Bv
6,7,Bv,3P
2,8,V9,aj
8,9,aj,Yf
3,5,xX,ky
7,10,3P,nF
1,3,Es,xX
1,7,Es,3P
1,4,Es,JW
4,8,JW,aj
2,10,V9,nF
2,4,V9,JW
4,9,JW,Yf
2,5,V9,ky
7,9,3P,Yf
2,6,V9,Bv
6,9,Bv,Yf
4,6,JW,Bv
3,8,xX,aj
5,7,ky,3P
5,8,ky,aj
6,8,Bv,aj
3,10,xX,nF
4,7,JW,3P
2,7,V9,3P
8,10,aj,nF
